  #########
    # #   #
# ### ### #
#   #     #
# # ##### #
# # #     #
# ### ### #
#     # # #
##### # # #
#     #    
#########   