  #####################
    #   # #     #     #
# ##### # ### # # #####
#             # # #   #
# ##### ####### # # ###
#   # #   # # # #     #
# ### ### # # ##### # #
#   # # # #         # #
### # # ####### ##### #
#   #   #   # # #   # #
# # # ##### # # # #####
# # #     #   #   # # #
### ### # # # # # # # #
#       #   #   #     #
# # # # ### # # ##### #
# # # # #   # # #     #
# ####### # ### # # ###
#   #     # # # # # # #
# ### ####### ##### # #
#   # #     #     # # #
# ####### ### # # # # #
#             # # #    
#####################   